0x000 0x000 0x000 0x000 0x000 0x000 0x000 0x000 0x000 0x000 0x000 0x000 0x000 0x000 0x000 0x000 0x000 0x000
0x000 0x000 0x000 0x000 0x000 0x000 0x000 0x000 0x000 0x000 0x000 0x000 0x000 0x000 0x000 0x000 0x000 0x000
0x000 0x000 0x000 0x000 0x000 0x000 0x000 0x000 0x000 0x000 0x000 0x000 0x000 0x000 0x000 0x000 0x000 0x000
0x000 0x000 0x000 0x000 0x000 0x000 0x000 0x000 0x000 0x000 0x000 0x000 0x000 0x000 0x000 0x000 0x000 0x000
0x000 0x000 0x000 0x000 0x000 0x000 0x000 0x000 0x000 0x000 0x000 0x000 0x000 0x000 0x000 0x000 0x000 0x000
0x000 0x000 0x000 0x000 0x000 0x000 0x000 0x000 0x000 0x000 0x000 0x000 0x000 0x000 0x000 0x000 0x000 0x000
0x000 0x000 0x000 0x000 0x000 0x000 0x000 0x000 0x000 0x000 0x000 0x000 0x000 0x000 0x000 0x000 0x000 0x000
0x000 0x000 0x000 0x000 0x000 0x000 0x000 0x000 0x000 0x000 0x000 0x000 0x000 0x000 0x000 0x000 0x000 0x000
0x000 0x000 0x000 0x000 0x000 0x000 0x000 0x000 0x000 0x000 0x000 0x000 0x000 0x000 0x000 0x000 0x000 0x000
0x000 0x000 0x000 0x000 0x000 0x000 0x000 0x000 0x000 0x000 0x000 0x000 0x000 0x000 0x000 0x000 0x000 0x000
0x000 0x000 0x000 0x000 0x000 0x000 0x000 0x000 0x000 0x000 0x000 0x000 0x000 0x000 0x000 0x000 0x000 0x000
0x000 0x000 0x000 0x000 0x000 0x000 0x000 0x000 0x000 0x000 0x000 0x000 0x000 0x000 0x000 0x000 0x000 0x000
0x000 0x000 0x000 0x000 0x000 0x000 0x000 0x000 0x000 0x000 0x000 0x000 0x000 0x000 0x000 0x000 0x000 0x000
0x000 0x000 0x000 0x000 0x000 0x000 0x000 0x000 0x000 0x000 0x000 0x000 0x000 0x000 0x000 0x000 0x000 0x000
0x000 0x000 0x000 0x000 0x000 0x000 0x000 0x000 0x000 0x000 0x000 0x000 0x000 0x000 0x000 0x000 0x000 0x000
0x002 0x000 0x000 0x000 0x000 0x000 0x000 0x000 0x000 0x000 0x000 0x000 0x000 0x000 0x000 0x000 0x000 0x000
0x000 0x002 0x000 0x000 0x000 0x000 0x000 0x000 0x000 0x000 0x000 0x000 0x000 0x000 0x000 0x000 0x000 0x000
0x000 0x000 0x000 0x000 0x000 0x000 0x000 0x000 0x000 0x000 0x000 0x000 0x000 0x000 0x000 0x000 0x000 0x000
0x000 0x000 0x000 0x000 0x000 0x000 0x000 0x000 0x000 0x000 0x000 0x000 0x000 0xf01 0xf01 0x000 0x000 0x000
0x000 0x000 0x000 0xf01 0xf01 0x000 0x000 0x000 0x000 0xf01 0xf01 0xf01 0x000 0x000 0x000 0x000 0x000 0x000
0x000 0x000 0x000 0x000 0x000 0x000 0x000 0x000 0x000 0x000 0x000 0x000 0x000 0x000 0x000 0x000 0x000 0x000
0x000 0x000 0x000 0x000 0x000 0x000 0x000 0x000 0x000 0x000 0x000 0x000 0x000 0x000 0x000 0x000 0x000 0x000
0xf01 0xf01 0xf01 0xf01 0xf01 0xf01 0xf01 0x000 0x000 0xf01 0xf01 0xf01 0xf01 0xf01 0xf01 0xf01 0xf01 0xf01
